0,0,0,0,0,0,0,0,0,0,0,0,0,0,0,0,0,0,0,0,0,0,0,0,0,0,0,0,0,0,0,0
0,,,,,,,,,,,,,,,,,,,,,10,10,10,1,,,10,,,,0
0,,,,,,,,,,,,,,,,,,,,,10,10,10,1,,,10,,,,0
0,,,,,,,,,,,,,,,,,,,,,10,10,10,1,,,10,,,,0
0,,100,,,,,,,,,,,,,,,,,,,10,10,10,1,,,10,,,,0
0,1,1,1,,,,,,,,10,10,10,,,,1,1,1,1,1,1,1,1,,,10,,,,0
0,,,,,,,,,,,10,10,10,,,,,,,,,,,,,,10,,,102,0
0,,,,,,,10,10,10,,10,10,10,,,,,,,,,,,,,,1,,1,1,1
0,,,,,,,10,10,10,,10,10,10,,1,1,1,,,,,,,,,,1,,,,0
0,,,10,10,10,,10,10,10,,10,10,10,,,,,,,,,,,,,,1,,,,0
0,,,10,10,10,,10,10,10,,1,1,1,,,,,,,,,,,,,,10,10,10,10,0
0,,,10,10,10,,10,10,10,,,,,,,,,,,,,,,,,,10,10,10,10,0
0,,,10,10,10,,1,1,1,,,,,,,,,,,,,,,,,,10,10,10,10,0
0,,,10,10,10,,,,,,,,,,,,,,,,,1,1,1,1,1,10,10,10,10,0
0,,,1,1,1,,,,,,,,,,,,,,,,,,,1,,,10,10,10,10,0
0,,,,,,,,,,,,,,,,,,,,,,,,1,,,10,10,10,10,0
0,1,1,1,,,,,,,,,,,,,,,,,,,10,10,1,,,10,10,10,10,0
0,10,10,1,,,,,,,,,,,,,,,,,,,10,10,1,,,10,10,10,10,0
0,10,10,1,,,,,,,,,,,,,,,,,,,10,10,1,,,1,10,10,10,0
0,10,10,1,,,,,,,,,,,,,,,,,,,10,10,1,,,1,10,10,10,0
0,10,10,1,,,,,,,,,,,,,,,,,,,10,10,1,,,1,10,10,10,0
0,10,10,1,,,,,,,,,,,,,1,1,1,,,,1,1,1,,,1,10,10,10,0
0,,,1,,,1,2,2,2,2,2,1,,,,1,2,2,2,2,2,2,2,1,,,1,10,10,10,0
0,,,,,,1,2,2,2,2,2,1,,,,1,2,2,2,2,2,2,2,1,,,1,10,10,10,0
1,1,1,1,1,1,1,1,1,1,1,1,1,1,1,1,1,1,1,1,1,1,1,1,1,1,1,1,1,1,1,1
